border_size=1
usage=map

Wo          , Wo          , Wo          , Wo          , Wo          , Wo          , Wo          , Wo          , Wo          , Wo          , Wo          , Wo          , Wo          , Wo          , Wo          , Wo          , Ww          , Ds          , Hd          , Hd          , Hd          , Hd          , Hd          , Hd          , Hd          , Hd          , Hd          , Hd          , Hd          , Hd          , Hd          , Hd          , Hd          , Dd          , Dd          , Dd          , Dd          , Dd          , Dd          , Dd          , Dd          , Dd          , Dd          , Dd          , Dd          , Dd          , Dd          , Dd          , Dd          , Dd          , Md          , Md          , Md          , Md          , Md          , Md          , Md          
Wo          , Wo          , Wo          , Wo          , Wo          , Wo          , Wo          , Wo          , Wo          , Wo          , Wo          , Wo          , Wo          , Wo          , Wo          , Wo          , Ww          , Ds          , Ds          , Dd^Vdt      , Hd          , Hd          , Hd          , Hd          , Hd          , Hd          , Ww          , Hd          , Hd          , Hd          , Hd          , Hd          , Dd          , Dd          , Ds          , Ds          , Ds          , Dd          , Ds          , Dd          , Dd          , Dd          , Dd          , Dd          , Hd          , Hd          , Ww          , Hd          , Dd          , Dd^Vda      , Dd          , Hd          , Hd          , Hd          , Hd          , Md          , Md          
Wo          , Wo          , Wo          , Wo          , Wo          , Wo          , Wo          , Wo          , Wo          , Wo          , Ww          , Wo          , Ww          , Wo          , Ww          , Ww          , Ww          , Ww          , Ch          , Hd          , Hd          , Hd          , Dd^Do       , Hd          , Hd          , Hd          , Hd          , Hd          , Dd          , Dd^Vda      , Dd          , Dd          , Ww^Bw|      , Ww          , Ww          , Ww          , Ww          , Ds          , Ww          , Ds          , Ds          , Dd^Vdt      , Ds          , Dd          , Dd          , Dd          , Dd          , Dd          , Ds          , Dd          , Dd          , Dd          , Dd          , Dd          , Hd          , Hd          , Md          
Wo          , Wo          , Wo          , Wo          , Wo          , Wo          , Wo          , Wo          , Ww          , Ww          , Ww          , Ww          , Ds          , Ww          , Ww          , Ww          , Ww          , Ww          , Ww^Bw/      , Ch          , Dd          , Dd          , Dd          , Gs          , Dd          , Hd          , Dd          , Dd          , Ww          , Dd^Do       , Ww          , Ww          , Ww^Bw|      , Ww          , Ww          , Ww          , Ww          , Ww          , Ww          , Wwf         , Wwf         , Ds          , Ds          , Ds          , Ds          , Dd          , Ce          , Ce          , 4 Ke        , Ce          , Dd          , Dd          , Dd^Dc       , Dd          , Dd          , Dd          , Ds          
Wo          , Wo          , Wo          , Wo          , Wo          , Wo          , Wo          , Ww          , Ww          , Ww          , Ww          , Ww          , Ds          , Ds          , Dd          , Ch          , Ch          , Ww^Bw/      , Ww          , Ww^Bw\      , Ww^Bw\      , Ww          , Ww          , Ww          , Ww          , Dd          , Dd          , Ww          , Ww          , Ww          , Ww          , Ww          , Ww^Bw|      , Ww          , Ww          , Ww          , Wwf         , Ww          , Wwf         , Wwf         , Wwf         , Ww          , Ww          , Ww          , Ww          , Ds          , Ds          , Ce          , Ce          , Ds          , Dd          , Dd          , Dd          , Dd          , Ds          , Dd^Vdt      , Dd          
Wo          , Wo          , Wo          , Wo          , Wo          , Wo          , Wo          , Ww          , Ww          , Ww          , Ww          , Ww          , Dd          , Hd          , Dd          , Dd          , Ds          , Ww          , Ww          , Ww          , Ww          , Ww^Bw\      , Ww^Bw\      , Ww          , Ww          , Ww          , Wwf         , Wwf         , Wwf         , Ww          , Ww          , Ww          , Ww^Bw|      , Ww          , Ww          , Ww          , Ww          , Wwf         , Wwf         , Wwf         , Ww          , Ww          , Ww          , Ww          , Ww^Bw/      , Ww^Bw/      , Ds^Dr       , Ds          , Ce          , Ds          , Dd          , Dd          , Dd          , Dd          , Gs          , Hd          , Dd          
Wo          , Wo          , Wo          , Wo          , Wo          , Wo          , Wo          , Ww          , Ww          , Ww          , Ds          , Ds          , Md          , Dd^Do       , Gs          , Gs          , Ds          , Ww          , Ww          , Ww          , Ww          , Wwf         , Wwf         , Ww^Bw\      , Ww^Bw\      , Ww          , Wwf         , Wwf         , Wwf         , Ww          , Ww          , Ww^Vm       , Ww^Bw|      , Ww^Vm       , Ww          , Ww          , Ww          , Ww          , Ww          , Wwf         , Ds          , Ww          , Ww^Bw/      , Ww^Bw/      , Ww          , Ww          , Ww          , Ds          , Ds          , Dd          , Ww          , Ww          , Gs          , Dd          , Md          , Dd^Do       , Dd          
Wo          , Wo          , Wo          , Wo          , Wo          , Wo          , Ww          , Ww          , Ww          , Ww          , Dd          , Hd          , Md          , Md          , Dd          , Dd          , Dd          , Ww          , Ww          , Wwf         , Wwf         , Ww          , Ww          , Ww          , Ww          , Ww^Bw\      , Ww^Bw\      , Wwf         , Wwf         , Ww          , Ww          , Ww          , Ww^Bw|      , Ww          , Ww          , Ww          , Wwf         , Ww          , Ww          , Ww          , Ds          , Ds          , Ww          , Wwf         , Wwf         , Ww          , Ww          , Ds          , Dd          , Ds          , Ww          , Ww          , Ww          , Hd          , Md          , Md          , Dd          
Wo          , Wo          , Wo          , Wo          , Wo          , Ww          , Ww^Vm       , Ww          , Ww          , Ds          , Dd          , Md          , Md          , Md          , Md          , Ww          , Ww^Bw|      , Ds          , Ww          , Ww          , Wwf         , Ww          , Ds          , Wwf         , Wwf         , Ww          , Ww          , Ww^Bw\      , Ww^Bw\      , Ww          , Ds^Bw/      , Ds^Bw\      , Ww^Bw/      , Ww          , Ww          , Ww          , Wwf         , Wwf         , Wwf^Bw/     , Wwf^Bw/     , Ww          , Ww          , Ww          , Ww          , Wwf         , Wwf         , Wwf         , Ds          , Gg          , Ds          , Dd^Vda      , Gs^Ft       , Ds          , Hd          , Dd          , Hd          , Md          
Wo          , Wo          , Wo          , Wo          , Wo          , Ww          , Ww          , Ww          , Ww          , Ds          , Hd          , Md          , Md          , Hd          , Dd          , Dd          , Dd          , Ww          , Ww          , Wwf         , Ww          , Ds          , Ds          , Wwf         , Wwf         , Wwf         , Ww^Vm       , Ww          , Ds          , Ds^Bw/      , Chw^Dr      , Chw^Dr      , 3 Kh        , Chw^Bw\     , Chw^Bw\     , Ww          , Ww^Bw/      , Ww^Bw/      , Ww^Vm       , Ww          , Ww          , Ww          , Ww          , Ww          , Ww          , Wwf         , Wwf         , Gg          , Gs          , Ds          , Gg          , Ds          , Ds          , Dd          , Md          , Hd          , Dd          
Wo          , Wo          , Wo          , Wo          , Wo          , Wo          , Wo          , Ww          , Ww          , Ds          , Hd          , Md          , Hd          , Hd          , Dd          , Dd^Do       , Dd          , Ww          , Ww          , Wwf         , Ww          , Ww          , Ww          , Wwf         , Ww          , Ww          , Ww          , Ww          , Ww          , Ds          , Ds          , Chw         , Ww          , Chw         , Ww          , Ww^Bw\      , Ww          , Ww          , Ww          , Ww          , Ww          , Ww          , Ww          , Ww          , Ww          , Ww          , Ww          , Ds          , Ds          , Gs          , Ds          , Gg          , Ds          , Hd          , Hd          , Hd          , Dd          
Wo          , Wo          , Wo          , Wo          , Wo          , Wo          , Ww          , Ww          , Gg          , Dd          , Dd          , Dd          , Dd          , Dd          , Gs          , Dd^Vdt      , Ds          , Ww          , Wwf         , Wwf         , Ww          , Ww          , Ww          , Ww          , Ww          , Ww          , Ww          , Ww          , Ww          , Ww          , Ds^Bw/      , Ds^Bw|      , Ds^Bw\      , Ww          , Ww          , Ww          , Ww          , Ww          , Ww          , Ww          , Ww          , Ww          , Ww          , Ww          , Ww          , Ww          , Ww          , Ds          , Ds          , Gs          , Gs          , Gs          , Ds          , Ds          , Gs^Ft       , Dd          , Gs          
Wo          , Wo          , Wo          , Wo          , Wo          , Ww          , Ww          , Ww          , Ww          , Gg          , Gg          , Gg          , Ww          , Gs          , Gs          , Gs          , Ds          , Ds          , Ww          , Ww          , Ww          , Ww          , Ww          , Ww          , Ww          , Ww          , Ww          , Ww          , Ww^Bw/      , Ww^Bw/      , Ww          , Ww          , Ww          , Ww^Bw\      , Ww^Bw\      , Ww          , Ww          , Ww          , Ww          , Ww          , Ww          , Ww          , Wwf         , Wwf         , Wwf         , Ww          , Wwf         , Ds          , Ds          , Ds          , Ds          , Gs          , Ds          , Ds          , Gs^Ft       , Gs^Ft       , Hh          
Wo          , Wo          , Wo          , Wo          , Wo          , Ww          , Ww          , Ww          , Ww          , Ww          , Gg          , Gg          , Gs^Ft       , Ww          , Ww^Bw|      , Gg          , Gg          , Ds          , Ww          , Ww          , Ww          , Ww          , Ww          , Ww          , Ww          , Ww          , Ww^Bw/      , Ww^Bw/      , Ww          , Ww          , Ww          , Ww^Vm       , Ww          , Ww^Vm       , Ww          , Ww^Bw\      , Wwf^Bw\     , Wwf         , Wwf         , Wwf         , Wwf         , Wwf         , Wwf         , Wwf         , Ss^Vm       , Wwf         , Gg          , Gs          , Gs          , Gs          , Gs          , Gs^Ft       , Gs          , Gs          , Ss^Vhs      , Hh          , Hh          
Wo          , Wo          , Wo          , Wo          , Wo          , Ww          , Ww          , Ww          , Ww          , Ww          , Gg          , Gg          , Gs^Ft       , Gs^Ft       , Ggf^Bw|     , Ww          , Ww          , Ww          , Ds          , Ww          , Ww          , Ww          , Ww          , Ww          , Ww^Bw/      , Ww^Bw/      , Ww          , Ww          , Ww          , Ww          , Wwf         , Wwf         , Wwf         , Ww          , Ww          , Ww          , Ww          , Ww^Bw\      , Ww^Bw/      , Wwf         , Wwf         , Wwf         , Wwf         , Wwf         , Ss          , Ss          , Ggf         , Gg          , Gg          , Gg          , Hh^Fp       , Gs          , Hh          , Hh          , Mm          , Mm          , Mm          
Wo          , Wo          , Wo          , Wo          , Wo          , Wo          , Wo          , Ww          , Ww          , Ww          , Gg          , Gs^Ft       , Gs^Ft       , Gs^Ft       , Gs^Bw\      , Gg          , Ww          , Gg          , Gs          , Ds          , Ww          , Ww          , Ww^Bw/      , Ww^Bw/      , Ww          , Wwf         , Wwf         , Wwf         , Wwf         , Wwf         , Ww          , Ww          , Ww          , Ww          , Ww          , Ww          , Ww^Bw/      , Ww^Bw/      , Wwf         , Ww^Bw\      , Wwf^Bw\     , Wwf         , Wwf         , Ss          , Ss          , Ggf         , Gg          , Ggf         , Hh          , Hh^Fp       , Hh          , Hh          , Ww          , Hh          , Mm          , Mm          , Mm          
Wo          , Wo          , Wo          , Wo          , Wo          , Wo          , Ww          , Ww          , Ww          , Ww          , Gs^Ft       , Gs^Ft       , Gs^Ft       , Gs^Ft       , Gs^Ft       , Ggf^Bw\     , Ss          , Gs          , Gs          , Ds          , Ww          , Ww^Vm       , Ww^Bw|      , Ww          , Wwf         , Wwf         , Ww          , Ww          , Ww          , Wwf         , Ww          , Ww          , Ww          , Ds          , Ds          , Ds          , Ww          , Wwf         , Wwf         , Wwf         , Wwf         , Wwf^Bw\     , Wwf^Bw|     , Ww          , Ww          , Ggf         , Gg          , Gg^Vc       , Hh          , Hh          , Ww          , Ww          , Hh          , Ww          , Mm          , Mm          , Mm          
Wo          , Wo          , Wo          , Wo          , Wo          , Ww^Vm       , Ww          , Ww          , Ww          , Ww          , Gs^Ft       , Gg          , Gs^Ft       , Gs^Ft       , Gs^Ft       , Ss^Bw|      , Gs^Ft       , Gs          , Gs^Ft       , Gs^Ft       , Ds^Bw|      , Ww^Bw/      , Wwf         , Wwf         , Wwf         , Ww          , Ww          , Ww          , Ww          , Wwf         , Ww          , Ww          , Ww          , Ds          , Ww          , Ww          , Ww          , Ww          , Ww          , Ww          , Ds          , Wwf         , Ss^Bw/      , Ss          , Gg          , Ww          , Ww          , Ww          , Ww^Bw|      , Ww          , Hh          , Hh          , Hh          , Mm          , Mm          , Mm          , Mm          
Wo          , Wo          , Wo          , Wo          , Ww          , Ww^Vm       , Ww          , Ww          , Ww          , Ww          , Ss          , Gg          , Ss          , Gs^Ft       , Ww          , Ww^Bw|      , Gs^Ft       , Gs^Ft       , Gs^Ft       , Gs^Ft       , Gs^Bw|      , Gs          , Gs^Ft       , Wwf         , Wwf         , Wwf         , Wwf         , Wwf         , Ww          , Ww          , Ww          , Ww          , Ww          , Ww          , Ww          , Ww          , Ww          , Ww          , Ww          , Ss          , Gg^Bw/      , Gg^Bw/      , Gg          , Gg          , Hh          , Hh^Fp       , Hh          , Ggf         , Hh          , Hh          , Hh^Fp       , Hh          , Hh          , Mm          , Mm          , Mm          , Mm          
Wo          , Wo          , Ww          , Ww          , Ww          , Ww          , Ww          , Ww          , Ww          , Ss          , Ss          , Ss          , Ss          , Ss          , Ss^Vhs      , Gg^Bw|      , Ss          , Gs          , Ss          , Ss          , Ss^Bw|      , Gs^Ft       , Gs^Ft       , Gs          , Gs          , Wwf         , Ds          , Wwf         , Ww          , Ww          , Ds          , Ww          , Ww          , Ww          , Ww          , Ww          , Ww          , Ww          , Ww          , Ss          , Ss^Bw|      , Hh          , Hh          , Hh          , Hh^Fp       , Hh^Fp       , Hh          , Hh          , Hh          , Hh^Fp       , Hh^Fp       , Hh          , Mm          , Mm          , Mm          , Ha^Vhha     , Mm          
Wo          , Ww          , Mm          , Mm          , Mm          , Ww          , Ww          , Ww          , Ss          , Ss          , Ss          , Ss          , Ss          , Ss          , Ss          , Ss^Bw\      , Gs^Ft       , Ss          , Ss          , Ss          , Ss^Bw|      , Gs^Ft       , Gs          , Gs^Ft       , Gs          , Gs          , Gs          , Ds          , Dd          , Ds          , Dd          , Ds          , Ds          , Ds          , Ds          , Ds          , Ss          , Ww          , Ww          , Ww          , Ww          , Ss^Bw\      , Hh          , Hh^Fp       , Hh          , Hh          , Ww          , Ss^Vm       , Hh          , Hh^Fp       , Hh          , Hh          , Hh          , Mm          , Mm^Xm       , Mm          , Mm          
Wo          , Ww          , Ww          , Mm          , Ww          , Ww          , Ww          , Ww          , Ww          , Ss          , Ss          , Ss          , Ss          , Ss          , Ss          , Ss^Bw|      , Gs^Ft       , Chs         , Ss          , Ss          , Ss^Bw/      , Gs          , Gs          , Gs^Ft       , Ss^Bw/      , Ss^Bw/      , Gg          , Gg          , Ggf         , Dd          , Dd^Do       , Dd          , Gs          , Ds          , Gs          , Gs          , Ss          , Ss          , Ss          , Ss          , Ss          , Ww^Bw|      , Ww^Bw\      , Gg          , Ww          , Ggf         , Ww          , Ww          , Ww          , Hh          , Hh          , Hh          , Mm          , Mm          , Mm          , Mm          , Mm          
Wo          , Wo          , Wo          , Ww          , Ww          , Ww          , Ww          , Ww          , Ss          , Ww          , Ww          , Ww          , Ww          , Ss          , Ss          , Ss^Bw|      , Uu^Bw\      , Ss          , Ss^Bw|      , Ss^Bw/      , Ss          , Ss          , Ss^Bw/      , Ss^Bw/      , Ss          , Ss          , Gs^Ft       , Gs^Ft       , Ss          , Ss          , Gs^Ft       , Gg          , Gs^Ft       , Gs          , Gs          , Ggf         , Ggf         , Ss          , Ss          , Ss^Vm       , Ss          , Ss          , Ss          , Ww^Bw\      , Ss^Bw\      , Ww          , Ss          , Ss          , Hh          , Ww          , Hh          , Mm          , Mm          , Mm          , Mm          , Mm          , Mm          
Wo          , Wo          , Wo          , Ww          , Ww          , Ww          , Ww          , Ss          , Ss          , Ss          , Ww          , Ss          , Ss          , Ss          , Gs^Ft       , Chr^Dr      , Chr         , Ss^Bw/      , Ss^Bw|      , Ss          , Ss          , Ss          , Ss^Bw|      , Ss          , Ss          , Ss          , Ss^Bw/      , Ss^Vm       , Ss          , Gs^Ft       , Gs^Ft       , Gs^Ft       , Gs^Ft       , Gs^Ft       , Gs^Bw/      , Gs          , Gs          , Ggf         , Ggf         , Ss          , Hh          , Hh          , Ggf         , Ww          , Ss^Bw/      , Cud         , Cud         , Cud         , Gg          , Ww          , Ww          , Mm          , Mm^Xm       , Mm          , Mm          , Mm          , Mm          
Wo          , Wo          , Wo          , Wo          , Ww          , Ww          , Ww          , Ww          , Ss          , Ss          , Ww          , Ss          , Ss          , Ss          , Ss          , Chr         , 1 Khr       , Chs         , Ss^Bw\      , Ss          , Ss          , Ss          , Ss^Bw/      , Ss          , Ss^Bw/      , Ss^Bw/      , Ss          , Ss^Bw\      , Ggf^Bw\     , Gs^Ft       , Gs^Ft       , Gs^Ft       , Gs^Bw/      , Gs^Bw/      , Gs^Ft       , Ww^Bw\      , Ww^Bw\      , Gs          , Gg          , Hh^Fp       , Hh          , Gg          , Ww^Bw/      , Ww^Bw/      , Gg          , Cud         , Qxu         , 2 Kud       , Hh          , Mm          , Mm          , Mm          , Mm          , Mm          , Mm          , Mm          , Mm^Xm       
Wo          , Wo          , Wo          , Wo          , Ww          , Ww          , Ww          , Ww          , Ss          , Ss          , Ss          , Ww          , Ww          , Ww          , Ss          , Ss          , Chr         , Chs         , Ss          , Ss^Bw\      , Ss^Bw\      , Ss^Bw/      , Ss          , Ss^Bw\      , Ww          , Ww^Vm       , Ss          , Ss          , Gs^Ft       , Ggf^Bw\     , Ss^Bw\      , Gs^Bw/      , Ss          , Gs^Ft       , Gs^Ft       , Ww          , Ww          , Ww^Bw\      , Ww^Bw\      , Gg          , Ww^Bw/      , Ggf^Bw/     , Ww          , Gg          , Hh          , Gg          , Hh          , Hh          , Hh^Fp       , Mm          , Mm          , Mm          , Ha          , Mm          , Ha^Vhha     , Mm          , Mm^Xm       
Wo          , Wo          , Ww          , Ww          , Ww          , Ww          , Ww          , Ss          , Ww          , Ww          , Ww          , Ss          , Ss          , Ss          , Ss          , Ss          , Ss          , Ss          , Ss          , Ss          , Ss          , Ss          , Ss          , Ss          , Ss          , Ss          , Gs^Ft       , Gs^Ft       , Gs^Ft       , Gs^Ft       , Gs^Bw|      , Gs^Vht      , Ss          , Ss          , Gs^Ft       , Ww          , Ww          , Ww          , Hh          , Ww^Bw|      , Ww          , Ww          , Hh          , Hh          , Mm          , Hh^Fp       , Mm          , Hh^Fp       , Mm          , Mm          , Mm          , Mm          , Mm^Xm       , Mm^Xm       , Mm^Xm       , Mm^Xm       , Mm^Xm       
Wo          , Wo          , Wo          , Ww          , Ww          , Ww          , Ww          , Ss          , Ss          , Ww          , Ss          , Ss          , Ss          , Ss          , Ww          , Ww          , Ww          , Ss^Vhs      , Ss          , Ss          , Ss          , Ss          , Chs         , Chs         , Ss          , Ss          , Gs^Ft       , Gs^Ft       , Gs^Ft       , Gs^Ft       , Gs^Ft       , Gs^Ft       , Gs^Ft       , Gs^Ft       , Gs^Ft       , Gs^Ft       , Gs^Ft       , Gs          , Gs          , Ss^Vhs      , Mm          , Ww          , Mm          , Mm          , Mm          , Mm          , Mm^Xm       , Mm          , Mm          , Mm          , Mm          , Mm          , Mm^Xm       , Mm^Xm       , Mm^Xm       , Mm^Xm       , Mm^Xm       
Wo          , Wo          , Ww          , Ww          , Ww          , Ww          , Ww          , Ss          , Ss          , Ss          , Ss          , Ss          , Gs^Ft       , Ss          , Ss          , Ww          , Ss          , Ss          , Ss          , Ss          , Ss          , Gs^Ft       , Gs^Ft       , Gs^Ft       , Gs^Ft       , Gs^Ft       , Gs^Ft       , Gs^Ft       , Gs^Ft       , Gs^Ft       , Gs^Ft       , Gs^Ft       , Gs^Ft       , Gs^Ft       , Gs^Ft       , Gs^Ft       , Gs^Ft       , Gs^Ft       , Gs          , Mm          , Mm          , Mm^Xm       , Mm          , Mm^Xm       , Mm^Xm       , Mm^Xm       , Mm^Xm       , Mm^Xm       , Mm          , Mm          , Mm          , Mm          , Mm^Xm       , Mm^Xm       , Ms          , Mm^Xm       , Ms          
Ww          , Wo          , Wo          , Ww          , Ww          , Ww          , Ww          , Gg          , Gg          , Ss          , Gg          , Gs^Ft       , Gs^Ft       , Gs^Ft       , Gg          , Gs^Ft       , Gg          , Gs^Ft       , Gg          , Gs^Ft       , Gg          , Gs^Ft       , Gg          , Gs^Ft       , Gs^Ft       , Gs^Ft       , Gs^Ft       , Gs^Ft       , Gs^Ft       , Gs^Ft       , Gs^Ft       , Gs^Ft       , Gs^Ft       , Gs^Ft       , Gg          , Gs^Ft       , Gg          , Gs^Fp       , Gs^Fp       , Gs^Fp       , Hh          , Mm          , Mm          , Mm          , Mm          , Mm          , Ms          , Ms          , Ms          , Mm          , Mm          , Mm          , Mm          , Ms          , Ms          , Ms          , Mm^Xm       
