border_size=1
usage=map

Wo          , Wo          , Wo          , Wo          , Ww          , Ds          , Hd          , Hd          , Hd          , Hd          , Hd          , Hd          , Hd          , Hd          , Hd          , Hd          , Md          , Md          , Md          , Hd          , Hd          , Dd          , Dd          , Dd          , Dd          , Dd          , Dd          , Dd          , Dd          , Dd          , Dd          , Dd          , Dd          , Dd          , Dd          , Dd          , Dd          , Dd          , Md          , Md          , Md          , Md          , Md          , Md          , Md          
Wo          , Wo          , Wo          , Wo          , Ww          , Ds          , Ds          , Dd^Vdt      , Hd          , Hd          , Hd          , Hd          , Hd          , Hd          , Ww          , Hd          , Hd          , Md          , Hd          , Hd          , Dd          , Dd          , Ds          , Ds          , Ds          , Dd          , Ds          , Dd          , Dd          , Dd          , Dd          , Dd          , Hd          , Hd          , Ww          , Hd          , Dd          , Dd^Vda      , Dd          , Hd          , Hd          , Hd          , Hd          , Md          , Md          
Ww          , Wo          , Ww          , Ww          , Ww          , Ww          , Dd          , Hd          , Hd          , Hd          , Dd^Do       , Hd          , Hd          , Hd          , Hd          , Hd          , Dd          , Dd^Vda      , Dd          , Dd          , Ww          , Ww          , Ww          , Ww          , Ww          , Ds          , Ww          , Ds          , Ds          , Dd^Vdt      , Ds          , Dd          , Dd          , Dd          , Dd          , Dd          , Ds          , Dd          , Dd          , Dd          , Dd          , Dd          , Hd          , Hd          , Md          
Ds          , Ww          , Ww          , Ww          , Ww          , Ww          , Ww          , Dd          , Dd          , Dd          , Dd          , Gs          , Dd          , Hd          , Dd          , Dd          , Ww          , Dd^Do       , Ww          , Ww          , Ww          , Ww          , Ww          , Ww          , Ww          , Ww          , Ww          , Wwf         , Wwf         , Ds          , Ds          , Ds          , Ds          , Dd          , Dd          , Dd          , 4 Dd        , Dd          , Dd          , Dd          , Dd^Dc       , Dd          , Dd          , Dd          , Ds          
Ds          , Ds          , Dd          , Dd^Vda      , Ds          , Ww          , Ww          , Ww          , Ww          , Ww          , Ww          , Ww          , Ww          , Dd          , Dd          , Ww          , Ww          , Ww          , Ww          , Ww          , Ww          , Ww          , Ww          , Ww          , Wwf         , Ww          , Wwf         , Wwf         , Wwf         , Ww          , Ww          , Ww          , Ww          , Ds          , Ds          , Dd          , Dd^Vdt      , Dd          , Dd          , Dd          , Dd          , Dd          , Ds          , Dd^Vdt      , Dd          
Dd          , Hd          , Dd          , Dd          , Ds          , Ww          , Ww          , Ww          , Ww          , Ww          , Ww          , Ww          , Ww          , Ww          , Wwf         , Wwf         , Wwf         , Ww          , Ww          , Ww          , Ww          , Ww          , Ww          , Ww          , Ww          , Wwf         , Wwf         , Wwf         , Ww          , Ww          , Ww          , Ww          , Ww          , Ww          , Ds          , Dd          , Ds          , Dd          , Dd          , Dd          , Dd          , Dd          , Gs          , Hd          , Dd          
Md          , Dd^Do       , Gs          , Gs          , Ds          , Ww          , Ww          , Ww          , Ww          , Wwf         , Wwf         , Ww          , Ww          , Ww          , Wwf         , Wwf         , Wwf         , Ww          , Ww          , Ww^Vm       , Ww          , Ww^Vm       , Ww          , Ww          , Wwf         , Ww          , Ww          , Wwf         , Ds          , Ww          , Ww          , Ww^Vm       , Ww          , Ww          , Ww          , Ds          , Ds          , Dd          , Ww          , Ww          , Gs          , Dd          , Md          , Dd^Do       , Dd          
Md          , Md          , Dd          , Dd          , Dd          , Ww          , Ww          , Wwf         , Wwf         , Ww          , Ww          , Ww          , Ww          , Ww          , Ww          , Wwf         , Wwf         , Ww          , Ww          , Ww          , Ww          , Ww          , Ww          , Ww          , Wwf         , Ww          , Ww          , Ww          , Ds          , Ds          , Ww          , Wwf         , Ww          , Ww          , Ww          , Ds          , Dd          , Ds          , Ww          , Ww          , Ww          , Hd          , Md          , Md          , Dd          
Md          , Md          , Md          , Ww          , Ww          , Ds          , Ww          , Ww          , Wwf         , Ww          , Ds          , Wwf         , Wwf         , Ww          , Ww          , Ww          , Ww          , Ww          , Ds          , Ds          , Ww          , Ww          , Ww          , Ww          , Wwf         , Wwf         , Wwf         , Wwf         , Ww          , Ww          , Ww          , Ww          , Wwf         , Ww          , Wwf         , Ds          , Gg          , Ds          , Dd^Vda      , Gs^Ft       , Ds          , Hd          , Ds          , Hd          , Md          
Md          , Hd          , Dd          , Dd          , Dd          , Ww          , Ww          , Wwf         , Ww          , Ds          , Ds          , Wwf         , Wwf         , Wwf         , Ww^Vm       , Ww          , Ds          , Ds          , Chw         , Chw         , 1 Khw       , Chw         , Chw         , Ww          , Ww          , Ww          , Ww^Vm       , Ww          , Ww          , Ww          , Ww          , Ww          , Ww          , Wwf         , Wwf         , Gg          , Gs          , Ds          , Gg          , Ds          , Ds          , Ds          , Md          , Hd          , Dd          
Hd          , Hd          , Dd          , Dd^Do       , Dd          , Ww          , Ww          , Wwf         , Ww          , Ww          , Ww          , Wwf         , Ww          , Ww          , Ww          , Ww          , Ww          , Ds          , Ds          , Chw         , Ww          , Chw         , Ww          , Ww          , Ww          , Ww          , Ww          , Ww          , Ww          , Ww          , Ww          , Ww          , Ww          , Ww          , Ww          , Ds          , Ds          , Gs          , Ds          , Gg          , Ds          , Hd          , Hd          , Hd          , Dd          
Dd          , Dd          , Gs          , Dd^Vdt      , Ds          , Ww          , Wwf         , Wwf         , Ww          , Ww          , Ww          , Ww          , Ww          , Ww          , Ww          , Ww          , Ww          , Ww          , Ds          , Ds          , Ds          , Ww          , Ww          , Ww          , Ww          , Ww          , Ww          , Ww          , Ww          , Ww          , Ww          , Ww          , Ww          , Ww          , Ww          , Ds          , Ds          , Gs          , Gs          , Gs          , Ds          , Ds          , Gs^Ft       , Dd          , Gs          
Ww          , Gs          , Gs          , Gs          , Ds          , Ds          , Ww          , Ww          , Ww          , Ww          , Ww          , Ww          , Ww          , Ww          , Ww          , Ww          , Ww          , Ww          , Ww          , Ww          , Ww          , Ww          , Ww          , Ww          , Ww          , Ww          , Ww          , Ww          , Ww          , Ww          , Wwf         , Wwf         , Wwf         , Ww          , Wwf         , Ds          , Ds          , Ds          , Ds          , Gs          , Ds          , Ds          , Gs^Ft       , Gs^Ft       , Hh          
Gs^Ft       , Ww          , Ww^Bw|      , Gg          , Gg          , Ds          , Ww          , Ww          , Ww          , Ww          , Ww          , Ww          , Ww          , Ww          , Wwf         , Ww          , Ww          , Ww          , Ww          , Ww^Vm       , Ww          , Ww^Vm       , Ww          , Ww          , Wwf         , Wwf         , Wwf         , Wwf         , Wwf         , Wwf         , Wwf         , Ww          , Ss^Vm       , Wwf         , Gg          , Gs          , Gs          , Gs          , Gs          , Gs^Ft       , Gs          , Gs          , Ss^Vhs      , Hh          , Hh          
Gs^Ft       , Gs^Ft       , Ggf         , Ww          , Ww          , Ww          , Ds          , Ww          , Ww          , Ww          , Ww          , Ww          , Ww          , Wwf         , Ww          , Ww          , Ww          , Ww          , Wwf         , Wwf         , Wwf         , Ww          , Ww          , Ww          , Ww          , Ww          , Ww          , Wwf         , Wwf         , Wwf         , Ww          , Wwf         , Ss          , Ss          , Ggf         , Gg          , Gg          , Gg          , Hh^Fp       , Gs          , Hh          , Hh          , Mm          , Mm          , Mm          
Gs^Ft       , Gs^Ft       , Ss          , Gg^Vc       , Ww          , Gg          , Gs          , Ds          , Ww          , Ww          , Ww          , Ww          , Wwf         , Wwf         , Wwf         , Wwf         , Wwf         , Wwf         , Ww          , Ww          , Ww          , Ww          , Ww          , Ww          , Ww          , Ww          , Wwf         , Ww          , Wwf         , Wwf         , Wwf         , Ss          , Ss          , Ggf         , Gg          , Ggf         , Hh          , Hh^Fp       , Hh          , Hh          , Ww          , Hh          , Mm          , Mm          , Mm          
Gs^Ft       , Gs^Ft       , Gs^Ft       , Ww          , Gs^Ft       , Gs          , Gs          , Ds          , Ww          , Ww^Vm       , Ww          , Ww          , Ww          , Wwf         , Ww          , Ww          , Ww          , Wwf         , Ww          , Ww          , Ww          , Ds          , Ds          , Ds          , Ww          , Wwf         , Wwf         , Wwf         , Wwf         , Wwf         , Wwf         , Ww          , Ww          , Ggf         , Gg          , Gg^Vc       , Hh          , Hh          , Ww          , Ww          , Hh          , Ww          , Mm          , Mm          , Mm          
Gs^Ft       , Gs^Ft       , Gs^Ft       , Gs          , Gs^Ft       , Gs          , Gs^Ft       , Gs^Ft       , Ds          , Ww          , Wwf         , Wwf         , Wwf         , Ww          , Ww          , Ww          , Ww          , Ww          , Ww          , Ww          , Ww          , Ds          , Ww          , Ww          , Ww          , Ww          , Ww          , Ww          , Ds          , Wwf         , Ss          , Ss          , Gg          , Ww          , Ww          , Ww          , Ww          , Ww          , Hh          , Hh          , Hh          , Mm          , Mm          , Mm          , Mm          
Gs^Ft       , Gs^Ft       , Ww          , Ww          , Gs^Ft       , Gs^Ft       , Gs^Ft       , Ss          , Gs          , Gs          , Gs^Ft       , Wwf         , Wwf         , Wwf         , Wwf         , Wwf         , Ww          , Ww          , Ww          , Ww          , Ww          , Ww          , Ww          , Ww          , Ww          , Ww          , Ww          , Ss          , Gg          , Gg          , Gg          , Gg          , Hh          , Hh^Fp       , Hh          , Ggf         , Hh          , Hh          , Hh^Fp       , Hh          , Hh          , Mm          , Mm          , Mm          , Mm          
Gs^Ft       , Gs^Ft       , Ss^Vhs      , Gg          , Gs^Ft       , Gs          , Ss          , Ss          , Gs^Ft       , Gs^Ft       , Gs^Ft       , Gs          , Gs          , Wwf         , Ds          , Wwf         , Ww          , Ww          , Ds          , Ww          , Ww          , Ww          , Ww          , Ww          , Ww          , Ww          , Ww          , Ss          , Ss          , Hh          , Hh          , Hh          , Hh^Fp       , Hh^Fp       , Hh          , Hh          , Hh          , Hh^Fp       , Hh^Fp       , Hh          , Mm          , Mm          , Mm          , Ha^Vhha     , Mm          
Gs^Ft       , Gs^Ft       , Ss          , Ss^Bw\      , Gs^Ft       , Ss          , Ss          , Gs^Ft       , Gs^Ft       , Gs^Ft       , Gs          , Gs^Ft       , Gs          , Gs          , Gs          , Ds          , Dd          , Ds          , Dd          , Ds          , Ds          , Ds          , Ds          , Ds          , Ss          , Ww          , Ww          , Ww          , Ww          , Ss          , Hh          , Hh^Fp       , Hh          , Hh          , Ww          , Ss^Vm       , Hh          , Hh^Fp       , Hh          , Hh          , Hh          , Mm          , Mm^Xm       , Mm          , Mm          
Gs^Ft       , Gs^Ft       , Ss          , Ss^Bw|      , Gs^Ft       , Chs         , Ss          , Gs^Ft       , Gs^Ft       , Gs          , Gs          , Gs^Ft       , Ss^Bw/      , Gs          , Gg          , Gg          , Ggf         , Dd          , Dd^Do       , Dd          , Gs          , Ds          , Gs          , Gs          , Ss          , Ss          , Ss          , Ss          , Ss          , Ww          , Ww          , Gg          , Ww          , Ggf         , Ww          , Ww          , Ww          , Hh          , Hh          , Hh          , Mm          , Mm          , Mm          , Mm          , Mm          
Gs^Ft       , Gs^Ft       , Ss          , Ss^Bw|      , Ss          , Ss          , Gs^Ft       , Gs^Ft       , Gs^Ft       , Gs^Ft       , Ss^Bw|      , Ss^Bw/      , Ss          , Gs^Ft       , Gs^Ft       , Gs^Ft       , Ss          , Ss          , Gs^Ft       , Gg          , Gs^Ft       , Gs          , Gs          , Ggf         , Ggf         , Ss          , Ss          , Ss^Vm       , Ss          , Ss          , Ss          , Ww          , Ss          , Ww          , Ss          , Ss          , Hh          , Ww          , Hh          , Mm          , Mm          , Mm          , Mm          , Mm          , Mm          
Gs^Ft       , Gs^Ft       , Gs^Ft       , Chr         , Chr         , Ss          , Ss          , Gs^Ft       , Gs^Ft       , Gs^Ft       , Ss^Bw|      , Ss          , Ss          , Ss          , Ss          , Ss^Vm       , Ss          , Gs^Ft       , Gs^Ft       , Gs^Ft       , Gs^Ft       , Gs^Ft       , Gs^Ft       , Gs          , Gs          , Ggf         , Ggf         , Ss          , Hh          , Hh          , Ggf         , Ww          , Ss          , Cud         , Cud         , Cud         , Gg          , Ww          , Ww          , Mm          , Mm^Xm       , Mm          , Mm          , Mm          , Mm          
Gs^Ft       , Gs^Ft       , Gs^Ft       , Chr         , 3 Khr       , Chs         , Ss^Bw\      , Ss          , Ss          , Ss          , Ss^Bw/      , Ss          , Ss          , Ss          , Ss          , Ss          , Ss          , Gs^Ft       , Gs^Ft       , Gs^Ft       , Gs^Ft       , Gs^Ft       , Gs^Ft       , Ww          , Ww          , Gs          , Gg          , Hh          , Hh          , Gg          , Ww          , Ww          , Gg          , Cud         , Qxu         , 2 Kud       , Hh          , Mm          , Mm          , Mm          , Mm          , Mm          , Mm          , Mm          , Mm^Xm       
Gs^Ft       , Gs^Ft       , Gs^Ft       , Ss          , Chr         , Chs         , Gs^Ft       , Ss^Bw\      , Ss^Bw\      , Ss^Bw/      , Ss          , Ss^Bw\      , Ww          , Ww^Vm       , Ss          , Ss          , Gs^Ft       , Gs^Ft       , Ss          , Gs^Ft       , Ss          , Gs^Ft       , Gs^Ft       , Ww          , Ww          , Ww          , Ww          , Gg          , Ww          , Ggf         , Ww          , Gg          , Hh          , Gg          , Hh          , Hh          , Hh          , Mm          , Mm          , Mm          , Mm          , Mm          , Ha^Vhha     , Mm          , Mm^Xm       
Gs^Ft       , Gs^Ft       , Gs^Ft       , Ss          , Ss          , Ss          , Ss          , Ss          , Gs^Ft       , Gs^Ft       , Ss          , Ss          , Ss          , Ss          , Gs^Ft       , Gs^Ft       , Gs^Ft       , Gs^Ft       , Gs^Ft       , Gg^Vc       , Ss          , Ss          , Gs^Ft       , Ww          , Ww          , Ww          , Hh          , Ww          , Ww          , Ww          , Hh          , Hh          , Mm          , Hh          , Mm          , Hh          , Mm          , Mm          , Mm          , Mm          , Mm^Xm       , Mm^Xm       , Mm^Xm       , Mm^Xm       , Mm^Xm       
Gs^Ft       , Gs^Ft       , Gs^Ft       , Gs^Ft       , Gs^Ft       , Ss^Vhs      , Gs^Ft       , Gs^Ft       , Gs^Ft       , Gs^Ft       , Chs         , Chs         , Ss          , Ss          , Gs^Ft       , Gs^Ft       , Gs^Ft       , Gs^Ft       , Gs^Ft       , Gs^Ft       , Gs^Ft       , Gs^Ft       , Gs^Ft       , Gs^Ft       , Gs^Ft       , Gs          , Gs          , Ss^Vm       , Mm          , Ww          , Mm          , Mm          , Mm          , Mm          , Mm^Xm       , Mm          , Mm          , Mm          , Mm          , Mm          , Mm^Xm       , Mm^Xm       , Mm^Xm       , Mm^Xm       , Mm^Xm       
Gs^Ft       , Gs^Ft       , Gs^Ft       , Gs^Ft       , Gs^Ft       , Gs^Ft       , Gs^Ft       , Gs^Ft       , Gs^Ft       , Gs^Ft       , Gs^Ft       , Gs^Ft       , Gs^Ft       , Gs^Ft       , Gs^Ft       , Gs^Ft       , Gs^Ft       , Gs^Ft       , Gs^Ft       , Gs^Ft       , Gs^Ft       , Gs^Ft       , Gs^Ft       , Gs^Ft       , Gs^Ft       , Gs^Ft       , Gs          , Mm          , Mm          , Mm^Xm       , Mm          , Mm^Xm       , Mm^Xm       , Mm^Xm       , Mm^Xm       , Mm^Xm       , Mm          , Mm          , Mm          , Mm          , Mm^Xm       , Mm^Xm       , Mm^Xm       , Mm^Xm       , Mm^Xm       
