border_size=1
usage=map

Wo          , Wo          , Wo          , Wo          , Wo          , Wo          , Wo          , Wo          , Wo          , Wo          , Ww          , Ww          , Ds          , Ss          , Ss          , Ss          , Ss          , Ss          , Ss          , Ss          , Ss          , Ss          , Ss          , Gs^Fp       , Hh          , Hh          , Hh          , Hh          
Wo          , Wo          , Wo          , Wo          , Wo          , Wo          , Wo          , Wo          , Wo          , Wo          , Ww          , Ww          , Ds          , Ss          , Gs^Ft       , Ss          , Ss          , Ss          , Ss^Vhs      , Ss^Bw/      , Ss^Bw\      , Ss          , Re^Gvs      , Re^Gvs      , Gg^Wm       , Gs^Fp       , Gs^Fp       , Hh          
Wo          , Wo          , Ds          , Ds          , Ds          , Wo          , Wo          , Wo          , Wo          , Wo          , Ww^Vm       , Ww          , Ds          , Ds          , Ds          , Gg          , Re^Uf       , Re^Gvs      , Ss          , Ss          , Ww          , Ss^Bw\      , Re          , Re^Gvs      , Re          , Hh^Vhh      , Gs^Fp       , Gs^Fp       
Ww          , Ww          , Wo          , Wo          , Wo          , Wo          , Wo          , Wo          , Wo          , Wo          , Wo          , Ww          , Ds          , Ds          , Ds          , Gg          , Re^Uf       , Re^Uf       , Ww          , Ww          , Ww          , Ss          , Re          , Re          , Ss          , Re^Gvs      , Ww          , Gs^Fp       
Ww          , Wo          , Wo          , Wo          , Wo          , Wo          , Wo          , Wo          , Wo          , Wo          , Wo          , Ww          , Ww          , Ds          , Gs^Ft       , Gs^Ft       , Ss          , Ss          , Ss          , Ww          , Ss          , Ss          , Re          , Ss          , Ww          , Ww          , Gs^Fp       , Ww          
Wo          , Wo          , Wo          , Wo          , Wo          , Wo          , Wo          , Wo          , Wo          , Wo          , Wo          , Ww          , Ww          , Rp          , Ss          , Ss          , Ss          , Ss          , Ss          , Ss          , Ss          , Ss          , Re          , Ss          , Ww          , Gs^Fp       , Gs^Fp       , Gs^Fp       
Wo          , Wo          , Wo          , Wo          , Wo          , Wo          , Wo          , Wo          , Wo          , Wo          , Wo          , Wo          , Wo          , Ww          , Ww          , Ss^Vhs      , Ww          , Ww          , Ww          , Ss          , Ww          , Ww          , Ww          , Ss^Bw\      , Ss          , Gs^Fp       , Gs^Fp       , Gs^Fp       
Wo          , Wo          , Wo          , Ww^Vm       , Wwr         , Wo          , Wo          , Wo          , Wo          , Wo          , Wo          , Wo          , Ww          , Ww          , Ww          , Ww          , Chs         , Chs         , Chw         , Ww          , Ww          , Ww^Vm       , Ss^Bw/      , Ss^Bw|      , Ss          , Ss          , Hh          , Hh          
Wo          , Wo          , Wo          , Wwr         , Wo          , Wo          , Wo          , Wo          , Wo          , Wo          , Wo          , Ww          , Ww          , Ww          , Ss          , Ss          , Chs         , 5 Khs       , Chr         , Ss          , Ss^Bw/      , Ww^Bw/      , Ww          , Ww          , Ww          , Ss          , Gs^Fp       , Hh          
Wo          , Wo          , Wo          , Wo          , Wo          , Wo          , Wo          , Wo          , Wo          , Wo          , Ww          , Ww          , Ww          , Ss          , Re^Uf       , Re          , Ss          , Chr         , Rd          , Rd          , Ss          , Ss          , Ss          , Ss          , Ss          , Ww          , Ww          , Gs^Fp       
Wo          , Wo          , Wo          , Wo          , Wo          , Wo          , Wo          , Wo          , Wo          , Wo          , Ww          , Ww          , Ss^Vm       , Ss          , Ss          , Re          , Rd          , Rd          , Ss          , Ss          , Ww          , Ss          , Ss          , Ss          , Ss          , Ss          , Gs^Fp       , Ww          
Wo          , Wo          , Wo          , Wo          , Wo          , Wo          , Wo          , Wo          , Ww          , Ww          , Ww          , Ds          , Ss          , Ss          , Ss          , Ss          , Rd          , Gs^Fp       , Gs^Fp       , Ss          , Ww          , Ww          , Ww          , Ss          , Ss          , Gs^Fp       , Gs^Fp       , Gs^Fp       
Wo          , Wo          , Wo          , Wo          , Wo          , Wo          , Wo          , Ww          , Ww          , Ww          , Ds          , Ds          , Ss          , Ss          , Ss          , Ss          , Gs^Fp       , Rd          , Gs^Fp       , Ss          , Ss          , Ww          , Ww          , Ss          , Ss          , Gs^Fp       , Gs^Fp       , Gs^Fp       
Wo          , Wo          , Wo          , Wo          , Ww          , Wo          , Ww          , Ww          , Ds          , Ds          , Ss          , Ss          , Re          , Ss          , Re          , Ss          , Re^Uf       , Ss^Vhs      , Ss          , Ss          , Ss          , Ww          , Ss          , Ss          , Re^Gvs      , Gg^Vh       , Gs^Fp       , Gs^Fp       
Wo          , Wo          , Ww          , Ww          , Ds          , Ww          , Ds          , Ds          , Ds          , Ss          , Ss          , Ss          , Re          , Chs         , Dd^Dr       , Re          , Ss          , Re^Uf       , Re          , Re          , Re          , Ss          , Ss          , Re          , Ss          , Re^Uf       , Gs^Fp       , Gs^Fp       
Wo          , Ww^Vm       , Wo          , Ww          , Wo          , Ww          , Wwf         , Wwf         , Ds          , Gg          , Gs^Ft       , Ss          , Ss          , Re          , Ds          , Ss          , Ss          , Ss          , Ss          , Re          , Ss          , Ss          , Ww          , Ww^Bw|      , Ww          , Ww          , Ww          , Gs^Fp       
Wo          , Wo          , Wo          , Wo          , Wo          , Wo          , Wwf         , Wwf         , Wwf         , Ds          , Ds          , Gs^Ft       , Gg          , Gg          , Ds          , Ss          , Ww          , Ww          , Ww          , Ss          , Ww          , Ww          , Ss^Bw|      , Ss^Bw/      , Ss          , Ss          , Chs         , Ww          
Wo          , Wo          , Wo          , Wo          , Wo          , Wo          , Wo          , Wwf         , Wwf         , Ds          , Ds          , Ds          , Ww          , Ds          , Ww          , Ww          , Ww          , Ww          , Ss          , Ww          , Ss          , Ss          , Re          , Ss          , Chs         , 4 Khs       , Gg          , Ss          
Wo          , Wo          , Wo          , Wo          , Wo          , Wo          , Wo          , Wwf         , Ww^Vm       , Ds          , Ww          , Ww          , Ww          , Ww          , Ww          , Ww          , Ss          , Ss          , Ss          , Ww          , Ss          , Ss          , Ss^Vhs      , Ss          , Ss          , Chs         , Re^Uf       , Gs^Fp       
Wo          , Wo          , Wo          , Wo          , Wo          , Wo          , Wo          , Wo          , Wo          , Ww          , Ww          , Ww          , Ww          , Ww          , Ds          , Ds          , Ss          , Gs^Ft       , Ss          , Ww          , Ww          , Ss          , Rd          , Ss          , Ss          , Re^Uf       , Ss          , Gs^Fp       
Wo          , Wo          , Ds          , Wo          , Wo          , Wo          , Wo          , Wo          , Wo          , Wo          , Ww          , Ww          , Ds          , Ds          , Ss          , Ss          , Ss          , Ss          , Ss          , Ss          , Ww^Bw/      , Rd          , Ss          , Ss          , Ss          , Ss          , Ww          , Ww          
Wo          , Ww^Vm       , Ds          , Wo          , Wo          , Wo          , Wo          , Wo          , Wwr         , Wo          , Ww          , Ds          , Ds          , Ss          , Chs         , Rp          , Re^Uf       , Ss          , Rd          , Rd          , Ss          , Ww          , Ww          , Rr          , Ww          , Ww          , Ww          , Ww          
Wo          , Ds          , Wo          , Wo          , Wo          , Wo          , Wo          , Wwr         , Wwr         , Ww          , Ww          , Ds          , Ds          , Ss          , Rr          , Rr          , Ss          , Ss          , Ss^Vhs      , Ss          , Ss          , Ss          , Ss          , Ww          , Ww          , Ww          , Ww          , Ww          
Wo          , Wo          , Wo          , Wo          , Wo          , Wo          , Wo          , Wo          , Wwr         , Ww          , Ww          , Ww          , Ss          , Ss          , Ss          , Ss          , Ss          , Ww          , Wwf         , Rp          , Ss          , Gs^Ft       , Ss          , Ss          , Ss          , Ww          , Ww          , Ww          
Wo          , Wo          , Wo          , Wo          , Wo          , Wo          , Wo          , Wo          , Wo          , Ww^Vm       , Ww          , Ww          , Ww          , Ww          , Ww          , Ss          , Ss          , Ss          , Re          , Re          , Ss          , Ss          , Chs         , Ss          , Ss          , Ss^Vm       , Ss          , Ss          
Wo          , Wo          , Wo          , Wo          , Wo          , Wo          , Wo          , Wo          , Ww          , Ww          , Ww          , Ds          , Ss          , Ss          , Ss          , Ss^Bw/      , Ss          , Ss          , Re          , Ss          , Ss          , Chs         , 3 Khs       , Chs         , Ss          , Gs^Fp       , Gs^Fp       , Gs^Fp       
Wo          , Wo          , Wo          , Wo          , Wo          , Wo          , Wo          , Wo          , Ww          , Ww          , Ds          , Ds          , Ss          , Ss          , Ww          , Ww          , Ss          , Ss          , Re          , Ss          , Ss          , Chs         , Chs         , Chs         , Ss          , Gs^Fp       , Gs^Fp       , Gs^Fp       
Wo          , Wo          , Chw         , Chw         , Chw         , Ww          , Ww          , Ww          , Ww          , Ww          , Ds          , Ss          , Ss          , Ss          , Ss          , Ww          , Ss          , Ss          , Ss          , Re          , Re          , Ss          , Ss          , Rr          , Ss          , Gs^Fp       , Gs^Fp       , Gs^Fp       
Wo          , Wo          , Chw         , 1 Khw       , Chw         , Ww^Vm       , Ww          , Ww          , Ds          , Ds          , Ss          , Ds          , Ss          , Ss          , Ss          , Ww          , Ww          , Ww          , Ww          , Ss          , Ss          , Re          , Ss^Vhs      , Ss          , Ss          , Gs^Fp       , Gs^Fp       , Gs^Fp       
Wo          , Ww          , Ww          , Chw         , Ww          , Ww          , Ww          , Ww          , Ds          , Ss^Vm       , Ss          , Ss          , Ss          , Gs^Ft       , Ss          , Ss^Vm       , Ss          , Ss          , Ss          , Ww          , Ww          , Ss          , Re^Uf       , Re^Uf       , Re^Uf       , Gs^Fp       , Gs^Fp       , Gs^Fp       
Wo          , Ww          , Ww          , Ww          , Ww          , Ww          , Ww          , Ww          , Ss          , Ss          , Ss          , Ss          , Ss          , Ss          , Ss          , Ss          , Ss          , Ss          , Ss          , Ss          , Ss          , Ww          , Ss          , Re^Uf       , Re^Uf       , Ss          , Gs^Fp       , Gs^Fp       
