border_size=1
usage=map

Wo          , Wo          , Wo          , Wo          , Wo          , Wo          , Wo          , Wo          , Wo          , Wo          , Wo          , Wo          , Wo          , Wo          , Wo          , Wo          , Wo          , Wo          , Wo          , Wo          , Wo          , Wo          , Wo          , Wo          , Wo          
Wo          , Wo          , Wo          , Wo          , Wo          , Wo          , Wo          , Wo          , Wo          , Wo          , Wo          , Wo          , Wo          , Wo          , Wo          , Wo          , Wo          , Wo          , Wo          , Wo          , Wo          , Wo          , Wo          , Wo          , Wo          
Wo          , Wo          , Wo          , Wo          , Wo          , Wo          , Wo          , Wo          , Ww          , Wo          , Ww          , Ww          , Ww          , Wo          , Wo          , Wo          , Wo          , Wo          , Wo          , Wo          , Wo          , Wo          , Wo          , Wo          , Wo          
Wo          , Wo          , Wo          , Wo          , Ww          , Ww          , Ww          , Ww          , Ww          , Dd          , Dd^Do       , Ww          , Ww          , Ww          , Wo          , Wo          , Wo          , Wo          , Wo          , Wo          , Wo          , Wo          , Wo          , Wo          , Wo          
Wo          , Wo          , Ww          , Ww          , Ww^Vm       , Ww          , Ds          , Ds          , Ds          , Ww          , Gs^Ft       , Dd          , Ww          , Ww          , Ww          , Wo          , Wo          , Wo          , Wo          , Wo          , Wo          , Wo          , Wo          , Wo          , Wo          
Wo          , Wo          , Ww          , Ww          , Ds          , Ww          , Ss          , Gs^Ft       , Gs^Ft       , Ww          , Gs^Ft       , Ww          , Ds          , Ww          , Ww          , Ww          , Wo          , Wo          , Wo          , Wo          , Ww          , Wo          , Wo          , Wo          , Wo          
Wo          , Wo          , Ww          , Ww          , Ww          , Ww          , Ww          , Gs^Ft       , Ww          , Ww          , Ww          , Gs^Ft       , Ds          , Ww          , Ww          , Ww          , Wo          , Wo          , Wo          , Ww          , 1 Kh        , Ww          , Wo          , Wo          , Wo          
Wo          , Wo          , Wo          , Ww          , Dd          , Dd          , Gs^Ft       , Ww          , Ss          , Ss          , Ds          , Ww          , Ww          , Ds          , Ww          , Wo          , Wo          , Wo          , Wo          , Chw         , Ww          , Ww          , Wo          , Wo          , Wo          
Wo          , Wo          , Wo          , Ww          , Ww          , Dd          , Dd          , Gs^Ft       , Dd          , Gs^Ft       , Gs^Ft       , Ds          , Ww^Vm       , Ww          , Ww          , Ww          , Ww          , Wo          , Wo          , Wo          , Wo          , Wo          , Wo          , Wo          , Wo          
Wo          , Wo          , Wo          , Ww          , Ww          , Ww          , Ww          , Dd^Do       , Ww          , Ds          , Ww          , Ww          , Ww          , Ww          , Ww          , 2 Ww        , Ww          , Wo          , Wo          , Wo          , Wo          , Wo          , Wo          , Wo          , Wo          
Wo          , Wo          , Wo          , Wo          , Wo          , Ww          , Ww          , Ww          , Ww          , Ww          , Ww          , Ww          , Wo          , Ww          , Wo          , Ww          , Wo          , Wo          , Wo          , Wo          , Wo          , Wo          , Wo          , Wo          , Wo          
Wo          , Wo          , Wo          , Wo          , Wo          , Wo          , Wo          , Wo          , Wo          , Ww          , Wo          , Wo          , Wo          , Wo          , Wo          , Wo          , Wo          , Wo          , Wo          , Wo          , Wo          , Wo          , Wo          , Wo          , Wo          
Wo          , Wo          , Wo          , Wo          , Wo          , Wo          , Wo          , Wo          , Wo          , Wo          , Wo          , Wo          , Wo          , Wo          , Wo          , Wo          , Wo          , Wo          , Wo          , Wo          , Wo          , Wo          , Wo          , Wo          , Wo          
Wo          , Wo          , Wo          , Wo          , Wo          , Wo          , Wo          , Wo          , Wo          , Wo          , Wo          , Wo          , Wo          , Wo          , Wo          , Wo          , Wo          , Wo          , Wo          , Wo          , Wo          , Wo          , Wo          , Wo          , Wo          
