border_size=1
usage=map

Ww          , Ww          , Ww          , Ww          , Ww          , Ww          , Gs^Fp       , Ss          , Ss          , Ss          , Ss          , Ss          , Ggf         , Ss          , Ss          , Ss          , Ss          , Ss          , Ss          , Ss          
Ww          , Ww          , Ww          , Ww          , Ww          , Ww          , Gs^Fp       , Ss          , Gs^Fp       , Gs^Fp       , Ss          , Ggf         , Ggf         , Ggf         , Ss          , Ss          , Ss^Vm       , Ww          , Ss          , Ss          
Ww          , Ww          , Ww          , Ww          , Ds          , Gs^Ft       , Rd          , Ss          , Ss          , Ss          , Gs^Fp       , Ggf         , Gs^Fp       , Ss          , Chs         , Ss          , Ss          , Ss          , Ss          , Ss          
Ww          , Ww          , Ww          , Ww          , Ww          , Ww          , Gs^Fp       , Ss          , Gs^Fp       , Gs^Fp       , Wo          , Gs^Fp       , Gs^Fp       , Ss          , Ss          , Ss          , Re^Uf       , Gs^Fp       , Gs^Fp       , Ss          
Ww          , Ww          , Ss          , Gs^Fp       , Re^Uf       , Gs^Fp       , Gs^Fp       , Ss          , Gs^Fp       , Wo          , Wo          , Wo          , Gs^Fp       , Ss          , Ss          , Re          , Re^Uf       , Gs^Fp       , Ss          , Ss          
Ww          , Ww          , Ss          , Re^Uf       , Ss          , Gs^Fp       , Ggf         , Re          , Ss          , Gs^Fp       , Gs^Fp       , Gs^Fp       , Ss          , Ss          , Ss          , Ss          , Ss          , Ss          , Ss          , Ss          
Ww          , Ww          , Gs^Fp       , Ss          , Ww          , Ss          , Ss          , Ss          , Gs^Fp       , Gs^Fp       , Re^Uf       , Ss          , Ss          , Ww          , Ss          , Ss          , Qxu         , Ss          , Ss          , Ss          
Ss          , Gs^Fp       , Gs^Fp       , Ss          , Ss          , Ss          , Gs^Fp       , Gs^Fp       , Gs^Fp       , Gs^Fp       , Gs^Fp       , Ss          , Ggf         , Ss          , Qxu         , Qxu         , Gs^Fp       , Qxu         , Ss          , Ss          
Ss          , Re^Uf       , Gs^Fp       , Ss^Vhs      , Gs^Fp       , Gs^Fp       , Gs^Fp       , Gs^Fp       , Ww          , Gs^Fp       , Gs^Fp       , Ss          , Ss          , Ss          , Gs^Fp       , Gs^Fp       , Ss^Vhs      , Gs^Fp       , Hh          , Gs^Fp       
Ss          , Re^Uf       , Gs^Fp       , Gs^Fp       , Gs^Fp       , Hh          , Gs^Fp       , Ww          , Ww          , Gs^Fp       , Gs^Fp       , Gs^Fp       , Gs^Fp       , Ss          , Ss          , Ss          , Gs^Fp       , Gs^Fp       , Hh          , Gs^Fp       
Ww          , Ss          , Gs^Fp       , Gs^Fp       , Gs^Fp       , Gs^Fp       , Ss          , Gs^Fp       , Gs^Fp       , Gs^Fp       , Gs^Fp       , Gs^Fp       , Gs^Fp       , Ss          , Ss          , Ss          , Ss          , Gs^Fp       , Gs^Fp       , Gs^Fp       
Ww          , Ss          , Ggf         , Ss          , Ss          , Ss          , Ss          , Ss          , Ss          , Gs^Fp       , Ss          , Ss          , Gs^Fp       , Ss          , Gs^Fp       , Gs^Fp       , Gs^Fp       , Gs^Fp       , Ss          , Ss          
Gs          , Gs          , Ss          , Ss          , Ss          , Ss          , Ss          , Ss          , Gg^Vc       , Ss          , Gs^Fp       , Ss          , Ss          , Ss          , Gs^Fp       , Hh          , Gs^Fp       , Re^Uf       , Ss          , Ss          
Ww          , Gs          , Gs          , Gs^Fp       , Ss          , Gs^Fp       , Gs^Fp       , Ggf         , Ss          , Ss          , Gs^Fp       , Gs^Fp       , Ss          , Ss          , Chs         , Gs^Fp       , Ss          , Ss          , Ss          , Ss          
Ww          , Ww          , Gs^Ft       , Ss          , Ss          , Re^Uf       , Gs^Fp       , Ss          , Ss          , Ss          , Ss          , Gs^Fp       , Ss          , Gs^Fp       , Ss          , Ss          , Ww          , Ww          , Ss          , Ss          
Ww          , Ww          , Gs^Ft       , Dd^Do       , Ss          , Gs^Fp       , Ss          , Ss          , Ss          , Ss          , Gs^Fp       , Ss          , Ss          , Ss          , Gs^Fp       , Ss          , Ww          , Ww          , Ww          , Ss          
Ww          , Ww          , Gs^Ft       , Gs^Ft       , Ww          , Ss          , Ss          , Ss          , Re          , Re^Uf       , Gs^Fp       , Gs^Fp       , Gs^Fp       , Gs^Fp       , Gs^Fp       , Ss          , Ss          , Ww          , Ss          , Ss          
Ww          , Ww          , Ww          , Gs^Ft       , Ww          , Ww          , Gs^Fp       , Ss          , Gs^Fp       , Gs^Fp       , Gs^Fp       , Ss          , Ss          , Gs^Fp       , Gs^Fp       , Gs^Fp       , Ss          , Ss          , Ss          , Ss          
Ww          , Ww          , Ww          , Gs^Ft       , Gs^Ft       , Ww          , Gs^Fp       , Gs^Fp       , Gs^Fp       , Gs^Fp       , Ww          , Ss          , Gs^Fp       , Gs^Fp       , Ss          , Ss          , Gs^Fp       , Gs^Fp       , Ss          , Ss          
Ww          , Ww          , Ww          , Ww          , Gs          , Gs^Fp       , Ww          , Ss          , Ss          , Gs^Fp       , Ss          , Ww          , Ss^Vhs      , Ss          , Ss          , Re          , Re^Uf       , Gs^Fp       , Gs^Fp       , Ss          
Ww          , Ww          , Ww          , Ww          , Ss          , Ss          , Ss          , Ss          , Ss          , Ss          , Qxu         , Ss          , Ss          , Ss          , Gs^Fp       , Ss          , Ss          , Ss          , Chs         , Ss          
Ww          , Ww          , Ww          , Ww          , Chw         , Ss          , Ss          , Ss          , Ss          , Qxu         , Qxu         , Qxu         , Ss          , Ss          , Gs^Fp       , Ss          , Ss          , Ss          , Ss          , Ss          
Ww          , Ww          , Ww          , Ww          , 1 Khw       , Chs         , Ss          , Ss          , Ss          , Ss          , Ss          , Ss          , Re          , Ss          , Ss          , Ss          , Gs^Fp       , Gs^Fp       , Gs^Fp       , Ss          
Ww          , Ww          , Ww          , Ww          , Ww          , Ss          , Ss          , Gs^Fp       , Gs^Fp       , Gs^Fp       , Gs^Fp       , Re^Uf       , Re^Uf       , Ss          , Ss          , Ggf         , Ggf         , Hh          , Gs^Fp       , Ss          
Ww          , Ww          , Ww          , Ww          , Ww          , Ww          , Ss          , Ss          , Ss          , Gs^Fp       , Ss          , Gs^Fp       , Ss          , Ss          , Ggf         , Gg^Vc       , Ggf         , Hh          , Gs^Fp       , Ss          
Ww          , Ww          , Ww          , Ww          , Ww          , Ww          , Gs^Fp       , Ss          , Ss          , Ss          , Ss          , Ss          , Ss          , Ss          , Ss          , Ggf         , Ss          , Ss          , Ss          , Ss          
