border_size=1
usage=map

Ww          , Ww          , Ww          , Ds          , Ds          , Ds          , Ss          , Ss          , Gg          , Gg          , Rd          , Gg          , Gg          , Gg          , Gg          , Ss          , Ss          , Ss          , Ss          , Ss          , Gg          , Gg          , Gg          , Gg          , Gg          , Gg          , Ss          , Ss          , Ss          , Ss          , Ss          , Gs^Fp       , Ss          , Ss          , Ss          , Ss          , Ss          , Ss          , Ss          , Gs^Fp       , Gs^Fp       , Ss          , Ss          , Hh          , Hh          , Hh          , Hh          
Ww          , Ww          , Wwf         , Wwf         , Wwf         , Ds          , Gs^Ft       , Gg          , Gg          , Gg          , Rd          , Gs^Fp       , Gs^Fp       , Gs^Fp       , Ss          , Ss          , Ss          , Ss          , Ss          , Ss          , Ss          , Gg          , Gg          , Gg          , Gg          , Ss          , Ss          , Ss          , Ww          , Ww          , Ww^Vm       , Ss          , Ss          , Ss          , Ss          , Ss          , Ss          , Ss          , Ss          , Ss          , Ss          , Ss          , Ss^Vhs      , Ss          , Ss          , Ss          , Ss          
Ww          , Ww          , Wwf         , Wwf         , Ww          , Ds          , Ds          , Gs^Ft       , Gs^Ft       , Gg          , Rd          , Gs^Fp       , Gs^Fp       , Ss          , Ss          , Re^Uf       , Re^Uf       , Ss          , Ss          , Ss          , Ss          , Ss          , Ss          , Ss          , Ss          , Gg          , Gg          , Ss          , Ss          , Ww          , Ss          , Ss          , Gs^Fp       , Gs^Fp       , Ss          , Cud         , Cud         , Cud         , Uu^Vud      , Ss          , Ss          , Ss          , Ss          , Gs^Fp       , Gs^Fp       , Ss          , Ss          
Ww          , Ww          , Ww          , Ww          , Ww          , Ds          , Ds          , Ds          , Ss          , Gg          , Ss^Vhs      , Gg          , Gg          , Ss          , Ss          , Re^Uf       , Ss          , Ss          , Ww          , Ss^Vm       , Ww          , Ww          , Ww          , Ss          , Ss          , Gs^Fp       , Gs^Fp       , Gs^Fp       , Re^Uf       , Ss          , Ss          , Ss          , Gs^Fp       , Gs^Fp       , Ss          , Ss          , Cud         , 2 Kud       , Uu^Vud      , Ss          , Ss          , Ss          , Gs^Fp       , Gg^Fet      , Gs^Fp       , Gs^Fp       , Ss          
Ww          , Ww          , Ww          , Ww          , Ww          , Ds          , Gs^Ft       , Ss          , Ss          , Re^Gvs      , Re          , Re^Gvs      , Ss          , Ss          , Ss          , Ss          , Ww          , Ww          , Ww          , Ww          , Ss          , Ww          , Ww          , Ww          , Ww          , Ss          , Ss^Bw/      , Ss^Vhs      , Ss          , Ss          , Ss          , Ss          , Ss          , Ss          , Re          , Cud         , Ss          , Cud         , Cud         , Rr          , Ss          , Ss          , Gs^Fp       , Gs^Fp       , Hh          , Hh          , Mm          
Ww          , Ww          , Ww          , Ww          , Ww          , Ds          , Gs^Ft       , Gs^Ft       , Ss          , Ss          , Re          , Ss          , Ss          , Ss          , Ss          , Ss          , Ww          , Ww          , Ww          , Ss          , Ss          , Ss          , Ss          , Ss          , Ww^Bw/      , Ss^Bw/      , Ss          , Re          , Re          , Ss          , Gs^Fp       , Gs^Fp       , Re          , Re          , Ss          , Ss          , Ss          , Ss          , Ss          , Ss          , Re          , Re          , Gs^Vht      , Gs^Fp       , Hh          , Mm          , Hh          
Ww          , Ww          , Wwf         , Ww          , Dd^Vda      , Ds          , Gs^Ft       , Gs^Ft       , Ss          , Ss          , Ss          , Re          , Re          , Ss          , Ss          , Ww          , Ww          , Ww          , Ss          , Ss          , Re^Uf       , Re^Uf       , Ss^Bw/      , Ss^Bw/      , Ss          , Ww          , Ss          , Ss          , Gs^Fp       , Re          , Re          , Ss          , Re          , Ss          , Re          , Ss          , Ss          , Ss          , Ss          , Re          , Ss          , Ss          , Ss          , Ss          , Gs^Fp       , Hh          , Gs^Fp       
Ww          , Wwf         , Wwf         , Ds          , Ds          , Ds          , Gs^Ft       , Ss          , Ss          , Ss          , Ss          , Ss          , Ss          , Re          , Ss^Vhs      , Ss          , Ss          , Ss          , Ss          , Ss          , Ss          , Ss          , Ww          , Ss          , Ss          , Ww          , Ss          , Gs^Fp       , Gs^Fp       , Ss          , Re          , Re          , Gg^Vc       , Re          , Ss          , Re          , Re          , Re          , Re          , Re          , Ss          , Ss          , Ss          , Ss          , Ss          , Ss          , Gs^Fp       
Ww          , Wwf         , Wwf         , Ds          , Ds          , Ds          , Ds          , Gs^Ft       , Ss          , Ss          , Ss          , Ss          , Ss          , Re^Gvs      , Re          , Re          , Re          , Ss          , Ss          , Ss          , Ww          , Ww          , Ss          , Ww          , Ww          , Ww          , Ww          , Ss          , Re          , Re          , Gg          , Gg          , Gg          , Gg          , Gg          , Ss          , Re          , Ss          , Ss          , Ss          , Ss          , Ss          , Gs^Fp       , Gs^Fp       , Gs^Fp       , Ss          , Hh          
Ww          , Ww          , Ww          , Ww          , Ds          , Ds          , Ds          , Ds          , Ds          , Ds          , Ww          , Ss          , Ww          , Ww          , Ww          , Ww          , Ww          , Re          , Ww^Bw\      , Ww          , Ss          , Ss          , Gg          , Ss          , Ss          , Ww          , Ww^Bw|      , Ww^Bw/      , Ww          , Ss          , Ss          , Gs^Fp       , Gs^Fp       , Gs^Fp       , Ss          , Ss          , Ss^Bw|      , Ss          , Ss          , Chs         , Ss          , Gs^Fp       , Ss          , Ss          , Ss          , Ss          , Hh          
Ww          , Ww          , Ww          , Ww          , Ww          , Ds          , Ww          , Ww          , Ww          , Ww          , Ss          , Ww          , Ss          , Ss          , Re          , Ss          , Ss          , Ww          , Ss          , Rd          , Rd          , Ss          , Ss          , Ss          , Ss          , Ss          , Gg          , Ss          , Ss          , Ww          , Wwf         , Ss          , Ss          , Ss          , Ss          , Ss          , Ss^Bw|      , Ss          , Ww          , Ss          , Ww          , Ss          , Ww          , Ss          , Ss          , Hh          , Hh          
Wo          , Wo          , Wo          , Ww          , Ww          , Ww          , Ss          , Ss          , Ss          , Ss          , Ss          , Ss          , Gg          , Ss          , Re^Gvs      , Ss          , Gg          , Ss          , Gg          , Ss          , Ss          , Rd          , Rd          , Ss          , Ss          , Gg          , Ss          , Ss          , Ss          , Ss          , Ww          , Ww          , Ww          , Ss^Vm       , Ww          , Ww          , Ss^Bw|      , Ww          , Ss          , Ww          , Ss          , Ww          , Ww          , Ww          , Ww          , Ss          , Hh          
Wo          , Wo          , Wo          , Ww          , Ww          , Ss          , Ds          , Ss          , Ss          , Ss          , Gg          , Ggf         , Ggf         , Re^Gvs      , Re^Gvs      , Ss          , Ss          , Gg          , Rd          , Gg          , Gg          , Gg          , Rd          , Rd          , Rd          , Gg          , Ss          , Ss          , Ww          , Ww          , Ss          , Ww          , Ss          , Ww          , Ss          , Ss          , Re          , Ss          , Ss          , Ss          , Ss          , Ww          , Ww^Vm       , Ww          , Ww          , Ss          , Ss          
Wo          , Wo          , Wo          , Ww          , Wwf         , Ww          , Ds          , Ds          , Ds          , Ss          , Ss          , Ggf         , Ss          , Ggf         , Gg^Vh       , Re^Gvs      , Rd          , Rd          , Ss          , Rd          , Rd          , Rd          , Gg^Vc       , Gg^Wm       , Gg^Vc       , Rd          , Ss          , Ss          , Ww          , Ss          , Ss          , Ss          , Ss          , Chs         , Ss          , Ss          , Re          , Ss          , Ww          , Ss          , Ss          , Ww          , Ww          , Ww          , Ss          , Ss          , Ss          
Wo          , Wo          , Ww          , Ww          , Wwf         , Wwf         , Ww          , Ds          , Ds          , Ss          , Ss          , Ss          , Ss          , Ggf         , Gg          , Rd          , Gg          , Ss          , Ss          , Re^Gvs      , Re^Gvs      , Gg          , Gg          , Gg^Vh       , Rd          , Rd          , Ss          , Ww          , Ss          , Ss          , Ss          , Ss          , Ss          , Ss          , Re          , Re          , Ss          , Ss^Bw\      , Ss^Bw\      , Ww          , Ss          , Ss          , Gs^Fp       , Ss          , Gs^Fp       , Gs^Fp       , Ss          
Wo          , Wo          , Wo          , Ww          , Ww          , Ww          , Ww          , Ww          , Ds          , Ss          , Ss          , Ss          , Ss          , Gg          , Ss          , Ss          , Gg          , Ss          , Ss          , Ss          , Re^Gvs      , Re^Gvs      , Re^Gvs      , Gg          , Rd          , Gg          , Ss          , Ww          , Ss          , Ss          , Ss          , Ss          , Re          , Re          , Gg^Vc       , Ggf         , Ss^Bw|      , Ww          , Ss          , Ss^Bw\      , Re          , Ss          , Ss          , Gs^Fp       , Ss          , Ss          , Ss          
Wo          , Wo          , Ww          , Ww          , Ww          , Ww^Vm       , Ww          , Ww          , Ds          , Ds          , Ds          , Ss          , Ww          , Ss          , Ww          , Ss          , Ss          , Gg          , Ss          , Ss^Vhs      , Ss          , Re^Gvs      , Rd          , Rd          , Ss          , Ss          , Ss          , Ww          , Ss          , Ss          , Re          , Re          , Gg          , Ggf         , Ggf         , Gs^Fp       , Ss^Bw|      , Ss          , Ss          , Ss          , Ss          , Re          , Re          , Ss          , Ss          , Ss          , Hh          
Wo          , Ww          , Ww          , Ww          , Ww          , Ww          , Ww          , Ww          , Ds          , Ds          , Gs^Ft       , Ss          , Ww          , Ww          , Ww          , Ww          , Ss          , Gg          , Ggf         , Ss          , Chs         , Rd          , Gg          , Ss          , Gg          , Gg          , Ww          , Ww          , Ss          , Ss          , Re          , Gg          , Gg          , Gg          , Ss          , Gs^Fp       , Ss          , Ggf         , Gg          , Ggf         , Ggf         , Ss          , Ss          , Re          , Re          , Hh          , Hh          
Ww          , Ww          , Ww          , Ww          , Ww          , Ww          , Ww          , Ds          , Dd^Dr       , Ds          , Gs^Ft       , Ss          , Ss          , Ww          , Ss^Vm       , Ss          , Ss          , Chs         , Chr         , Gg          , Gg          , Khs         , Gg          , Gg          , Gg          , Gg          , Ww          , Ss          , Ss          , Ss          , Re          , Ggf         , Gg          , Ss          , Ss          , Ss          , Ss          , Ggf         , Ww          , Ww          , Ww          , Ggf         , Gs^Fp       , Ss          , Re          , Hh          , Mm          
Ww          , Ww          , Ww          , Ww          , Ww          , Ww          , Ds          , Ds          , Ss          , Gs^Ft       , Ss          , Ss          , Ss          , Ss          , Ss          , Ss          , Gg          , Chr         , Rd          , Gg          , Ggf         , Gg          , Ww          , Gg          , Ww          , Ww          , Re^Uf       , Ss          , Gs^Fp       , Ss          , Re          , Ggf         , Ss          , Ss          , Ss          , Gs^Fp       , Ss          , Ggf         , Ww          , Ww          , Gg          , Gg          , Gs^Fp       , Ss          , Re          , Ss          , Mm          
Ww          , Ww          , Ww          , Ww          , Ww          , Ww          , Ds          , Ds          , Ss          , Ss          , Ww          , Ss          , Ww          , Ss          , Ss          , Ss          , Ss          , Gg          , Rd          , Ggf         , Ww          , Ww          , Ww          , Ww          , Ss          , Re^Uf       , Gs^Fp       , Gs^Fp       , Ss          , Ss          , Re          , Ss          , Ss          , Ss          , Gs^Fp       , Gs^Fp       , Ss          , Ggf         , Ggf         , Gg          , Gs^Fp       , Gs^Fp       , Ss          , Ss          , Re          , Hh          , Hh          
Ww          , Ww          , Ww          , Ww          , Wwf         , Ww          , Ds          , Ss          , Ww          , Ww          , Ww          , Ww          , Ww          , Ww          , Ww          , Ss          , Ss^Bw|      , Ss^Bw/      , Ww          , Ww          , Ww          , Ww          , Ww          , Ss          , Ss          , Ss          , Ss          , Gs^Fp       , Ss          , Ss          , Ss^Vhs      , Re          , Ss          , Ss          , Ss          , Gs^Fp       , Ss^Bw|      , Ggf         , Ss          , Ss          , Ss          , Gs^Fp       , Ss          , Re          , Ss          , Ss          , Hh          
Ww          , Ww          , Wwf         , Wwf         , Wwf         , Ds          , Ww          , Ww          , Ww          , Ww          , Ww          , Ww          , Ww          , Ww          , Ww          , Ww          , Ss^Bw|      , Ww          , Ww          , Ww          , Ss          , Ww          , Ss          , Ww          , Ww          , Ww          , Ww          , Ss          , Ss          , Ss          , Ss          , Re          , Ss          , Ss          , Ss          , Ss          , Ss          , Ss          , Gs^Fp       , Ss          , Ss          , Ss          , Ss^Vhs      , Re          , Ss          , Ss          , Hh          
Ww          , Ww          , Ww          , Wwf         , Ww          , Ww          , Ww          , Ww          , Ww          , Ww          , Gs^Ft       , Ss          , Ss          , Ss          , Ss          , Ww          , Ss^Bw|      , Ww          , Ss          , Ss          , Ww          , Ss          , Re          , Ss          , Ss          , Ss^Vm       , Ss          , Ww          , Ww          , Ss          , Re          , Re          , Ss          , Ss          , Ss          , Chs         , Khs         , Gs^Fp       , Chr         , Gs^Fp       , Ss          , Gs^Fp       , Gs^Fp       , Re^Uf       , Hh          , Hh          , Hh          
Ww          , Ww          , Ww          , Ww          , Ww          , Ww          , Ww          , Ww          , Gs^Ft       , Gs^Ft       , Ss          , Ss          , Ss          , Re^Gvs      , Ss^Vhs      , Ss^Bw/      , Ss          , Ss          , Ss          , Ss          , Ss          , Ss          , Gs^Fp       , Ss          , Ss          , Ss          , Ss          , Ss          , Re          , Ww^Bw/      , Ww          , Ss          , Ss          , Ss          , Ss          , Ss          , Chs         , Gs^Fp       , Gs^Fp       , Gs^Fp       , Gs^Fp       , Ss          , Ss          , Gs^Fp       , Ss          , Hh          , Ss          
Ww          , Ww^Vm       , Ww          , Ww          , Ww          , Ww          , Ww          , Ss          , Ss          , Ss          , Ss          , Gs^Fp       , Re          , Re          , Ggf         , Ggf         , Ss          , Ss          , Ss          , Gs^Fp       , Gs^Fp       , Gs^Fp       , Gs^Fp       , Gs^Fp       , Ss          , Ss          , Ss          , Re          , Ss          , Ss          , Ss          , Ww          , Ss          , Ss          , Ss          , Ss          , Ss          , Gs^Fp       , Gs^Fp       , Gs^Fp       , Gs^Fp       , Ss          , Ss          , Ss          , Ss          , Hh          , Mm          
Ww          , Ww          , Ww          , Ww          , Ww          , Ww          , Chw         , Ss          , Ss          , Ww          , Re          , Re          , Ss          , Ss          , Ggf         , Ss          , Gg          , Ss          , Ss          , Ss          , Ss          , Ss          , Ss          , Ss          , Ss          , Ss          , Ss          , Re          , Gg          , Ss          , Ss          , Ww          , Ww          , Ss          , Ss          , Ss          , Ww          , Ss          , Ww          , Ss          , Ss          , Ss          , Ss          , Ss          , Hh          , Hh          , Ww          
Wo          , Ww          , Ww          , Ww          , Ww          , Chw         , 1 Khw       , Chs         , Re          , Re          , Ww          , Ww          , Ss          , Ggf         , Ggf         , Ggf         , Gg          , Gg          , Gg          , Ss          , Ss          , Ww          , Ggf         , Ss          , Ww          , Ww          , Ss          , Ss^Bw|      , Ss          , Ss          , Ss          , Ss          , Ss          , Ww          , Ww          , Ww          , Ww          , Ww          , Ss          , Ww          , Ss^Bw/      , Ss          , Ss          , Ss          , Ww          , Ww          , Hh          
Wo          , Wo          , Ww          , Ww          , Ww          , Chw         , Chw         , Chs         , Re          , Ss          , Ss          , Ww          , Ss          , Ggf         , Re^Uf       , Re^Uf       , Re^Uf       , Ss          , Ss          , Gg          , Gg          , Ss          , Ss          , Ss          , Ss          , Ss          , Ss          , Ss^Bw|      , Ss^Bw\      , Gg          , Ss          , Ss          , Ss          , Ss          , Ww          , Ww          , Ww          , Ss          , Ss          , Ss          , Ss^Bw|      , Ww          , Ww          , Ww          , Ss          , Ss          , Hh          
Wo          , Wo          , Wo          , Ww          , Ww          , Gs^Ft       , Ds          , Ss          , Re          , Ss          , Ss          , Ss          , Ss          , Ss          , Re^Uf       , Re^Uf       , Ss          , Re          , Re          , Ss          , Gg          , Ss          , Ss          , Ss          , Ss          , Ss          , Gg          , Re          , Gg^Vc       , Ss          , Ss          , Ss          , Ss          , Ss          , Ww          , Ww          , Ss          , Ss          , Ss          , Ss          , Re          , Ss          , Ss          , Ss          , Ss          , Hh          , Hh          
Wo          , Wo          , Ww          , Ww          , Gs^Ft       , Gs^Ft       , Ds          , Ds          , Ds          , Gs^Ft       , Gs^Ft       , Ss          , Ss          , Ss          , Ss          , Ss          , Ss^Vm       , Ss          , Ss          , Ss          , Ss          , Gg          , Ss          , Ss          , Ss          , Gg          , Ss          , Gg          , Ss          , Gg          , Ss          , Ss          , Ww          , Ww          , Ss          , Ss          , Ss          , Ss          , Ss          , Ss          , Re          , Ss^Vhs      , Re^Uf       , Ss          , Ss          , Hh          , Hh          
Wo          , Wo          , Ww          , Gs^Ft       , Ds          , Ds          , Ds          , Ds          , Ds          , Ds          , Ds          , Gs^Ft       , Ss          , Ss          , Ss          , Ss          , Ss          , Ss          , Ss          , Ss          , Re^Uf       , Ss          , Re^Uf       , Ss          , Ss          , Ss          , Ss          , Ss          , Ss          , Ss          , Ww          , Ww          , Ss          , Ss          , Ss          , Ss          , Ss          , Ss          , Ss          , Ss          , Ss          , Re          , Ss          , Ss          , Ss          , Ss          , Ss          
