border_size=1
usage=map

Ds          , Gs^Ft       , Ds          , Gs^Ft       , Gs          , Gs^Ft       , Gs^Ft       , Gs^Ft       , Gs^Ft       , Gs^Ft       , Gs^Ft       , Gs^Fp       , Gs^Fp       , Gs^Fp       , Hh          , Hh          , Gs^Fp       , Gs^Fp       , Gs^Fp       , Gs^Fp       , Gs^Fp       , Gs^Fp       
Ww          , Ds          , Ww          , Ds          , Ww          , Ds          , Ds          , Ds          , Gs          , Gs^Ft       , Gs^Fp       , Ss          , Gs^Fp       , Gs^Fp       , Hh          , Hh          , Hh          , Gs^Fp       , Mm^Xm       , Gs^Fp       , Mm          , Gs^Fp       
Ww          , Ww          , Ww          , Ww          , Ww          , Ww          , Ww          , Ds          , Gs^Ft       , Gs^Ft       , Gs^Fp       , Ww          , Gs          , Gs^Ft       , Gs^Ft       , Gs          , Gs          , Gs^Ft       , Mm          , Mm^Xm       , Mm^Xm       , Mm          
Ww          , Ww          , Ww          , Ww          , Wwf         , Wwf         , Wwf         , Ds          , Gs^Ft       , Gs^Ft       , Gs^Ft       , Gs^Ft       , Gs          , Gs^Ft       , Ce          , Ss          , Gs^Ft       , Gs^Vht      , Gs^Ft       , Gs          , Gs^Ft       , Gs^Ft       
Wo          , Ww          , Ww          , Ww          , Wwf         , Wwf         , Wwf         , Ds          , Gs          , Gs^Vht      , Gs          , Gs^Ft       , Gs^Ft       , Ce          , 2 Ke        , Ce          , Ds          , Gs          , Ss          , Gs^Ft       , Gs^Ft       , Gs^Ft       
Wo          , Wo          , Ww          , Ww          , Ww          , Wwf         , Wwf         , Ds          , Ds          , Gs          , Gs          , Ds          , Ss          , Ce          , Ce          , Ce          , Ds          , Gs          , Ss          , Ww          , Gs^Ft       , Gs^Ft       
Wo          , Wo          , Ww          , Ww          , Ww^Vm       , Ww          , Wwf         , Wwf         , Ww          , Ds          , Ds          , Ss          , Ss          , Ds          , Ds          , Ds          , Gs          , Ss          , Ww          , Ww          , Ww          , Gs^Ft       
Wo          , Wo          , Wo          , Ww          , Ww          , Ww          , Ww          , Ww          , Ww          , Ww          , Ds          , Ss          , Ds          , Ds          , Ds          , Ds          , Ww          , Ww          , Ss          , Gs^Ft       , Gs^Ft       , Gs^Ft       
Wo          , Wo          , Wo          , Wo          , Ww          , Ww          , Ww          , Ww          , Ww          , Ww          , Wwf         , Ww          , Wwf         , Wwf         , Wwf         , Ww          , Ds          , Gs          , Gs          , Ds          , Gs          , Gs^Ft       
Wo          , Wo          , Wo          , Wo          , Ww          , Ww          , Ww          , Ww          , Ds          , Wwf         , Wwf         , Wwf         , Ds          , Dd^Vda      , Ds          , Ds          , Ds          , Ds          , Ds          , Ds          , Ds          , Gs^Ft       
Wo          , Wo          , Wo          , Wo          , Ww          , Ww          , Ww          , Wwf         , Wwf         , Wwf         , Wwf         , Wwf         , Ds          , Rd          , Rd          , Rd          , Rd          , Rd          , Rd          , Ds          , Gs^Ft       , Ds          
Wo          , Wo          , Wo          , Ww          , Ww          , Ww          , Ds          , Ww          , Ds          , Ds          , Wwf         , Wwf         , Ds          , Ds          , Ds          , Ds          , Ds          , Ds          , Gg          , Rd          , Ds          , Gs^Ft       
Wo          , Wo          , Wo          , Ww          , Ww          , Ww          , Ww          , Ww          , Ww          , Ds          , Ww          , Ww          , Ds          , Ds          , Gs          , Ds          , Ggf         , Ggf         , Re^Uf       , Ss^Vhs      , Gs^Ft       , Gs^Ft       
Wo          , Wo          , Wo          , Ww^Vm       , Ww          , Ww          , Ww          , Ww          , Ww          , Wwf         , Ww          , Ds          , Ds          , Ds          , Ds          , Ww          , Ds          , Ss          , Gs          , Gs^Ft       , Gs^Ft       , Gs^Ft       
Wo          , Wo          , Wo          , Wo          , Ww          , Ww          , Ww          , Ww          , Wwf         , Ww          , Ww          , Ww          , Ww          , Ds          , Ds          , Ds          , Ds          , Ds          , Gs^Ft       , Gs^Ft       , Gs^Ft       , Gs^Ft       
Wo          , Wo          , Wo          , Wo          , Ww          , Ww          , Ww          , Wwf         , Wwf         , Wwf         , Ds          , Ds          , Ds          , Ww^Bw/      , Ww          , Ww          , Ww          , Ss          , Ss          , Ss          , Gs^Fp       , Gs^Ft       
Wo          , Wo          , Wo          , Ww          , Ww          , Ww          , Wwf         , Wwf         , Wwf         , Wwf         , Ds          , Dd^Dr       , Ds          , Ds          , Ds          , Rd          , Ggf         , Ggf         , Ss          , Gs          , Gs^Fp       , Gs^Fp       
Wo          , Wo          , Ww          , Ww          , Ww          , Wwf         , Wwf         , Wwf         , Wwf         , Wwf         , Wwf         , Ds          , Dd^Vdt      , Ds          , Rd          , Rd          , Gg          , Re          , Re          , Re          , Ww          , Gs^Fp       
Wo          , Wo          , Ww          , Ww          , Wwf         , Ww          , Wwf         , Wwf         , Wwf         , Ww          , Wwf         , Ds          , Ds          , Ds          , Ds          , Rd          , Rd          , Rd          , Rd          , Ds          , Ds          , Gs^Fp       
Wo          , Wo          , Ww          , Ww          , Ww          , Ww          , Ww          , Wwf         , Ww          , Ww          , Ww          , Ds          , Ds          , Ds          , Ds          , Ds          , Rd          , Ds          , Rd          , Ds          , Hd          , Hd          
Wo          , Wo          , Wo          , Ww^Vm       , Ww          , Ww          , Ww          , Ww          , Ww          , Ww          , Ww          , Ww          , Ds          , Ww          , Wwf         , Wwf         , Ds          , Ds          , Ds          , Rd          , Dd^Vda      , Hd          
Wo          , Wo          , Wo          , Wo          , Ww          , Ww          , Ds          , Ww          , Ce          , Ww          , Ww          , Ww          , Ww          , Ww          , Ww          , Wwf         , Ds          , Ww          , Dd          , Dd          , Hd          , Hd          
Wo          , Wo          , Wo          , Wo          , Ww          , Ww          , Ds          , Ce          , 1 Ke        , Ce          , Ds          , Ww          , Ww          , Ww          , Ds          , Wwf         , Ww          , Ds          , Dd          , Dd          , Dd          , Hd          
Wo          , Wo          , Wo          , Wo          , Ww          , Ww          , Ds          , Ce          , Ce          , Ce          , Dd          , Ww          , Ww          , Ww          , Ww          , Ww          , Ww          , Ds          , Dd          , Dd^Dc       , Dd          , Hd          
Wo          , Wo          , Wo          , Ww          , Ww          , Ww          , Ww          , Dd          , Dd          , Dd          , Ww          , Ww          , Ww          , Ww          , Ww          , Ww          , Ww          , Dd          , Dd          , Dd          , Dd          , Hd          
Wo          , Wo          , Ww          , Ww          , Ww          , Ww          , Ww          , Ww          , Ww          , Ww          , Ww          , Ww          , Ww          , Ww^Vm       , Ww          , Ww          , Wwf         , Dd          , Dd          , Dd^Do       , Hd          , Ds          
Wo          , Wo          , Ww          , Ww          , Ww          , Ww          , Ww          , Ww          , Ww          , Ww          , Ww          , Ww          , Ww          , Ww          , Ww          , Ww          , Ww          , Dd          , Ds          , Dd          , Md          , Md          
Wo          , Wo          , Ww          , Ww          , Ww          , Ww          , Ww          , Ww          , Ww          , Ww          , Ww          , Ww          , Ww          , Ww          , Ww          , Ww          , Ww          , Dd          , Ds          , Hd          , Ds          , Md          
